9,
1, 1, 0,
2, 5, 1,
4, 5, 1,
4, 3, 1,
8, 3, 1,
8, 5, 1,
6, 9, 4,
4, 9, 4,
1, 10, 0,
